tht that
ryt right
dats that's
dat that
hvae have
teh the
wwhat what
cn can
im I'm
i'm I'm
i'v I've
Ive I've
i've I've
i'll I'll
Ill I'll
i'd I'd
thats that's
thta that
thtas that's
evry every
thts that's
evry1 everyone
evrybody everybody
every1 everyone
eevry1 everyone
eevry every
some1 someone
sm1 someone
any1 anyone
id I'd
nw now
thnk think
duz does
cant can't
cnt can't
shud should
shouldnt shouldn't
shudnt shouldn't
shd should
wont won't
thre there
u you
de the
da the
fink think
thts that's
r are
wht what
whats what's
defo definitely
gna going to
gonna going to
whts what's
wat what
wats what's
der there
ders there's
d'ya do you
wwell well
wwe we
i I
shoul should
def definitely
waat what
whaat what
whaaat what
waaat what
sud should
coz because
cos because
'cause because
cuz because
ith with
wr where
whould would
wud would
wd would
soo so
dr doctor
explaine explain
k ok
dey they
den then
wots what's
wot what
jus just
hes he's
scietist scientist
sciece science
sience science
dunno don't know
ur your
didnt didn't
susie Susie
tom Tom
pilt pilot
pilit pilot
susi Susie
riviera Riviera
rivera Riviera
Dr. doctor
DR doctor
nick Nick
nik Nick
nic Nick
DR. doctor
suisi Susie
suisie Susie
waht what
waht's what's
wahts what's
d the
cmn common
cz because
tak talk
tru true
bt but
rite right
susei Susie
thnk think
abt about
b be
shd should
shdnt shouldn't
ny any
ny1 anyone
dis this
whtver whatever
whtever whatever
watever whatever
wtevr whatever
wtever whatever
wt what
jst just
wid with
dn don't
dnt don't
giv give
smthin something
smtin something
sometin something
tryn trying
thngs things
thng thing
smthng something
somethng something
ppl people
gv give
frst first
frstly firstly
frsly firstly
frs first
susier Susie
sm some
smone someone
smbody somebody
bcos because
tmo Tom
tommy Tom
tomm Tom
neeed need
shes she's
hes he's
theres there's
Iv I've
Ive I've
youve you've
toms Tom is
nicks Nick is
shudv should have
shouldve should have
shudve should have
cd could
cud could
cudv could have
couldv could have
couldve could have
os is
hopw how
hows how's
kno know
duno don't know
womans woman's
n and
noe know
sayn saying
sayin saying
whus who's
whu who
whum whom
luk look
whr where
frm from
nt not
shld should
shldnt shouldn't
shldn't shouldn't
knw know
knws knows
wanna want to
ws was
wana want to
prob problem
wsnt wasn't
wsn't wasn't
strt start
agn again
hav have
ma my
dont don't
m am
tym time
gona going to
yup yes
isnt isn't
sed said
fout thought
gd good
altho although
althou although
aint isn't
alrite alright
amd and
ballon balloon
balon balloon
baloon balloon
beter better
chuk chuck
derkins Derkins
deric Derkins
discus discuss
disucs discuss
gota gotta
inevatably inevitably
iof if
lifes lives
nowere nowhere
od odd
oviously obviously
por poor
regnant pregnant
secnd second
valuble valuable
150pounds	150 pounds
7month	7 months
7months	7 months
A	a
aa	a
aaaaaaaaaaaaaaaaaaaaaaaaaaaaaaaaaaaaaaaaaaaaaaaaaaaaaaaaaaaaaaaaaaaaaaaaaaaaaaaaaaaaaaaaaaaaaaaaaaaaaaaaaaaaaaaaaaaaaaaaaaaaaaaaaaaaaaaaaaaaaa	a
ao	a
abrother	a brother
alittle	a little
ALOT	a lot
alot	a lot
aprat	a prat
asacrificce	a sacrifice
avote	a vote
abdulnasser	Abdulnasser
ablre	able
ABOUT	about
BOUT	about
aabout	about
abdout	about
abiout	about
abou	about
abouit	about
aboutt	about
abpuot	about
abut	about
baout	about
bout	about
bouta	about
oabt	about
acces	access
accessable	accessible
accidently	accidentally
accomlished	accomplished
acconlogment	acknowledgement
ackonlogment	acknowledgement
accross	across
actig	acting
actua	actual
actualli	actually
actualy	actually
actuyally	actually
adquate	adequate
ADULTS	adults
affecte	affected
affecyted	affected
affectiong	affecting
africa	Africa
afta	after
afterh	after
aftre	after
aftyer	after
iafter	after
aftershavve	aftershave
aagen	again
agai	again
gain	again
agains	against
AGREE	agree
agrre	agree
agrt	agreed
agrement	agreement
aah	ah
ahaaa	ah
ahcr	ah
ahhH	ah
ahhahahahahahahahahahah	ah
ahhh	ah
ahhhhhhhhhhhhhh	ah
ahn	ah
aw	ah
ay	ah
ayeeyo	ah
ahshould	ah should
alex	Alex
ALIENS	aliens
ALIVE	alive
aliveatever	alive at ever
ALL	all
ALLLL	all
aall	all
al	all
alll	all
alyt	all
oall	all
alldie	all die
alow	allow
ALLOWED	allowed
allowe	allowed
allowsd	allowed
alobne	alone
alrdy	already
alreadi	already
alreadyt	already
alreay	already
alredy	already
alsoo	also
altso	also
aslo	also
elso	also
wlso	also
alterbat	alternative
alterbnative	alternative
althoug	although
althought	although
altiude	altitude
ALWAYS	always
allwayss	always
alwatys	always
'm	am
AM	am
amm	am
ama	am a
amazin	amazing
americ	America
america	America
american	American
americfan	American
amina	Amina
amoutns	amount
+	and
AND	and
ad	and
adn	and
anc	and
andf	and
anf	and
ansd	and
fand	and
nd	and
andrew	Andrew
angelina	Angelina
nangry	angry
annouying	annoying
anoying	annoying
enoying	annoying
anoys	annoys
ANOTHER	another
anothe	another
anover	another
anuva	another
ANSWER	answer
anser	answer
answ	answer
asnwer	answer
ANSWERING	answering
antibiotis	antibiotics
ANY	any
aany	any
ANYONE	anyone
ANYTHING	anything
anyfin	anything
anyhthing	anything
anyrthing	anything
anythin	anything
wnything	anything
anuyway	anyway
anuyways	anyway
anw	anyway
anway	anyway
anytway	anyway
anyways	anyway
anywayzzzzzzzzzzzzzzzzzzzzz	anyway
neways	anyway
newys	anyway
nywys	anyway
anywere	anywhere
Apple	apple
arab-israeli	Arab-Israeli
arash	Arash
're	are
ARE	are
arent	aren't
Arrrrrrrrrrrrrrrrrrrrrrrrrrrrrrrrrrrrrrrrrrrrrrrr	argh
aghh	argh
aergue	argue
arguement	argument
arcnold	Arnold
ias	as
aswell	as well
ASBO	asbo
ASKED	asked
Ass	ass
assest	assets
assestts	assets
asistant	assistant
assisstant	assistant
assu	assume
assumptionp	assumption
assuption	assumption
astra	Astra
AT	at
aty	at
t\/at	at
atleast	at least
atlweast	at least
atemt	attempt
australia	Australia
auther\/author	author
automatikkk	automatic
aw8at	await
awail	await
AWESOME	awesome
awsome	awesome
akward	awkward
babys	babies
BABY	baby
abbaby	baby
bqby	baby
bac	back
bak	back
badg	badge
BADRINATH	badrinath
BALLOON	balloon
abaloon	balloon
ablloon	balloon
alloon	balloon
ballo	balloon
ballon	balloon
ballonn	balloon
balloo	balloon
ballooj	balloon
balloomn	balloon
ballooon	balloon
balloooon	balloon
baloo	balloon
baloon	balloon
baloonn	balloon
balooo	balloon
balooon	balloon
baloun	balloon
basllon	balloon
blballoon	balloon
bloon	balloon
boaloon	balloon
boloon	balloon
pballoon	balloon
ballonflying	balloon flying
baloonok	balloon ok
balloing	ballooning
balloonin	ballooning
baLLONS	balloons
balloms	balloons
ballons	balloons
baloons	balloons
banans	bananas
bareee	bare
bas	base
basted	bastard
BASTARDS	bastards
bayb	bay
BE	be
b	be
bei	be
eb	be
ebe	be
fb	be
tbe	be
bnick	be Nick
bnot	be not
bthe	be the
bethrown	be thrown
beautoiful	beautiful
ause	because
bcoz	because
bcz	because
beacuse	because
beause	because
becase	because
becasue	because
becaue	because
becayse	because
becouse	because
becoz	because
becuase	because
becuse	because
cau	because
couse	because
coz	because
cozs	because
cus	because
cvuz	because
ebecome	become
becommingh	becoming
bn	been
bnf	been
ibn	been
nbeen	been
b4	before
be4	before
bfor	before
bhai	behave
bhavin	behaving
BEING	being
bein	being
bng	being
mbeing	being
biengs	beings
belie	believe
beliee	believe
believe	believe
believei	believe
belive	believe
delieved	believed
BELIEVES	believes
belives	believes
belivess	believes
believeinng	believing
benefical	beneficial
bengali	Bengali
bentley	Bentley
BEST	best
btr	better
bttr	better
bhups	Bhups
biffg	big
buggest	biggest
BILLIONS	billions
biologicalproblems	biological problems
sbiomed	biomed
lbit	bit
bitchin	bitching
blacvk	black
blazey	Blaze
blazzzzzzzzzzzzzzzzzzzzzzey	Blaze
blazin	blazing
bluddy	bloody
BOAT	boat
BOB	Bob
BOBB	Bob
BOBBY	Bob
bobb	Bob
borij	boring
BORN	born
browin	borrowing
BOTH	both
botlle	bottle
BOY	boy
boyo	boy
brad	Brad
BRAIN	brain
branson	Branson
brav	brave
breakas	break as
breakthrought	breakthrough
rbrilliant	brilliant
BRINK	brink
british	British
broder	brother
brov	brother
Brought	brought
buddha	Buddha
budy	buddy
bullyed	bullied
bumpd	bumped
Business	business
BUT	but
bu	but
buit	but
buth	but
buyt	but
byut	but
cbut	but
BY	by
aby	by
abyt	by
bychance	by chance
btw	by the way
BYE	bye
camn	came
CAN	can
ca	can
cand	can
cann	can
canr	can
csncans	can
CANCER	cancer
camcer	cancer
cance	cancer
cancesr	cancer
cancr	cancer
caner	cancer
canvcer	cancer
cnacer	cancer
candyy	candy
CANY	can't
caant	can't
cant	can't
cantfly	can't fly
capacirty	capacity
CAR	car
CARD	card
carreer	career
carooooot	carrot
caroot	carrot
acrry	carry
carrun	carry
cary	carry
caryyi	carry
CARRYING	carrying
carryin	carrying
carvin	carving
caase	case
cae	case
cas	case
caht	cat
catseach	cats each
celss	cells
CHANCE	chance
chace	chance
chaneces	chances
chang	change
chager	charger
CHARRRLELLLLESSS	Charles
charlottes	Charlotte's
chattin	chatting
chelsea	Chelsea
CHILD	child
CHIRLD	child
cgild	child
chid	child
chikld	child
childs	child
chils	child
chld	child
chinease	Chinese
choi9vce	choice
choic	choice
choice	choice
CHOOSE	choose
choosed	chose
chrissie	Chrissie
christians	Christians
christie	Christie
christmas	Christmas
chucjk	chuck
chucky	chuck
chuick	chuck
CHUCKED	chucked
chuked	chucked
chuckin	chucking
chukin	chucking
CHUCKY	Chucky
inema	cinema
cirlces	circles
classs	class
cleever	clever
climbin	climbing
clubs\/societies	clubs societies
collabopr	collaborate
collegaues	colleagues
collegues	colleagues
COM	come
COME	come
cme	come
com	come
coome	come
cum	come
fcom	come
comeon	come on
cummon	come on
cumftably	comfortably
comming	coming
COMMENT	comment
compplicated	complicated
complicatin	complication
compupa	computer
computin	computing
concieved	conceived
concludde	conclude
concludsion	conclusion
confuzin	confusing
connor	Connor
cinsider	consider
considere	consider
concideratiion	consideration
considerin	considering
contiunued	continued
contrafctions	contractions
contry	contrary
CHONTROL	control
conrol	control
contol	control
contrl	control
contro	control
controll	control
controlllll	control
controllthe	control the
contraversial	controversial
converstation	conversation
convo	conversation
convinvced	convinced
kl	cool
corect	correct
correcto	correct
corectle	correctly
couild	could
coukd	could
couled	could
couls	could
couyld	could
qould	could
cuda	could have
couldnt	couldn't
cudnt	couldn't
couting	counting
COUPLE	couple
coulpe	couple
couople	couple
coupkle	couple
crach	crack
crazzy	crazy
crickeet	cricket
crue	cruel
cruing	crying
CURE	cure
Cure	cure
cur	cure
curem	cure
cuure	cure
qure	cure
ccuring	curing
cutlar	cutler
cyn	Cynthia
cynthia	Cynthia
DAD	dad
da3e	Daisy
da3i	Daisy
dam	damn
dammit	damn
damon	damn
dem	damn
dan	Dan
daniel	Dan
DARLIN	darling
darren	Darren
dave	Dave
DAY	day
ady	day
dayzzzz	days
ded	dead
DEATH	death
dcide	decide
decideds	decided
decieded	decided
deciveddddd	decided
deiceded	decided
DECISION	decision
deciciosn	decision
decison	decision
deeeeep	deep
DEFEND	defend
DEFENDIG	defending
deffinately	definitely
deffintely	definitely
deffintily	definitely
deffo	definitely
definaely	definitely
definartely	definitely
definately	definitely
definatkly	definitely
definatley	definitely
defininatluyy	definitely
definitly	definitely
definnitely	definitely
defintly	definitely
deif	definitely
efdefinately	definitely
sdefo	definitely
del	delete
deltet	delete
deltng	deleting
dellusional	delusional
demans	demands
DENTIST	dentist
depresed	depressed
dirive	derive
Derkin	Derkins
derkinds	Derkins
derkins	Derkins
develp	develop
dic	dick
ddnt	didn't
dint	didn't
DIE	die
DIEEEEEEE	die
fdie	die
DIES	dies
diess	dies
differenhce	difference
DIFFERENT	different
diff	different
dfficult	difficult
diffcult	difficult
dificult	difficult
dilema	dilemma
dir	direct
direc	direct
dis-agree	disagree
disster	disaster
disassters	disasters
discOver	discover
discoverand	discover and
dicovered	discovered
discoverd	discovered
discovrd	discovered
discoverin	discovering
discrovering	discovering
discivers	discovers
DISCUSS	discuss
dicuss	discuss
discusss	discuss
dscuss	discuss
discussin	discussing
dicussion	discussion
deisease	disease
digusting	disgusting
disguisting	disgusting
devorce	divorce
dna	DNA
DO	do
dob	do
doo	do
dooo	do
donot	do not
DOC	doctor
DOCTOR	doctor
DR	doctor
DR.	doctor
Doc	doctor
Doctor	doctor
Dr	doctor
Dr.	doctor
Drr	doctor
GP	doctor
dfoctor	doctor
dioc	doctor
doc	doctor
doco	doctor
docot	doctor
docotrs	doctor
docrtor	doctor
docter	doctor
doctopr	doctor
doictor	doctor
dorctor	doctor
dotor	doctor
dr	doctor
dr.	doctor
fdoctor	doctor
foctor	doctor
docs	doctor's
doctors	doctor's
doctots	doctor's
doctro	doctor's
doctrs	doctor's
drs	doctor's
documentsed	documents
DOES	does
doe	does
dos	does
ds	does
DOESNT	doesn't
d0esnt	doesn't
doesn	doesn't
doesnt	doesn't
dosent	doesn't
dpesnt	doesn't
doin	doing
gdoing	doing
dol	doll
doman	domain
doen	done
don	done
donn	done
donr	done
donw	done
wdone	done
diont	don't
dnt	don't
dont	don't
dontn	don't
donto	don't
dunt	don't
odnt	don't
dunno	don't know
dor	door
dorothy	Dorothy
dwn	down
dramtically	dramatically
DRIVE	drive
DRIVING	driving
droped	dropped
droping	dropping
droppin	dropping
8dude	dude
dudel	dude
dumm	dumb
donno	dunno
dieing	dying
dyin	dying
dyng	dying
E	e
EACH	each
eac	each
eachother	each other
eariler	earlier
easuer	easier
EASY	easy
educata	educate
effecrts	effects
effience	efficiency
ege	eg
eh	eh
ehe	eh
ehy	eh
ehyyyyy	eh
eitha	either
eitherway	either way
elese	else
embarassing	embarrassing
embarrsaa	embarrassing
emrgency	emergency
emoth	emotion
amotional	emotional
emoptional	emotional
emotionssssssss	emotions
END	end
End	end
edn	end
engirneer	engineer
enginneers	engineers
english	English
ENOUGH	enough
enopught	enough
enuf	enough
enuff	enough
er	erm
ermm	erm
ermmm	erm
especialy	especially
ETC	etc
etc.	etc
ETHICALLY	ethically
eveloves	Eve loves
EVEN	even
eventaully	eventually
eva	ever
evern	ever
evers	ever
EVERYBODY	everybody
everybodddddddddy	everybody
eer1	everyone
erveryone	everyone
eveyone	everyone
evryone	everyone
ever1s	everyone's
everyones	everyone's
everythin	everything
everythings	everything
evrythin	everything
evill	evil
oevil	evil
eactly	exactly
exatlyy	exactly
xctly	exactly
exervise	exercise
ecxiasing	exercising
EXIST	exist
expensic	expensive
EXPERIENCE	experience
expereince	experience
xperince	experience
ecxperienced	experienced
experimnt	experiment
expreriment	experiment
expolained	explained
EYE	eye
fairnes	fairness
faiza	Faiza
fallin	falling
fallingi	falling
fallning	falling
familt	family
FAR	far
farrrrrrrrrrrrrrrrrr	far
gfar	far
fasti	fast
fatherb	father
fatherbut	father but
fafvior	favour
favor	favour
feelng	feeling
50\/50	fifty-fifty
figer	figure
FIGURED	figured
fiji	Fiji
fincal	final
finacially	financially
findi	find
findin	finding
finidn	finding
finiesh	finish
finshed	finished
finsings	finishing
1st	first
fisrt	first
fitst	first
FIVE	five
fizzer	Fizzer
flakey	flaky
flamin	flaming
flightsssss	flights
flyinga	fling a
flt	fly
fly\/land\/not	fly and not
flythat	fly that
FLYING	flying
flyin	flying
fetus	foetus
fetuses	foetuses
FOR	for
fior	for
fror	for
ffs	for fucks sake
furel	for real
forse	force
4ever	forever
FOEFOREVER	forever
4GET	forget
4get	forget
frget	forget
fgiure	forgive
fgive	forgive
4gort	forgot
fiorgot	forgot
formn	form
formul	formula
FOUND	found
franz	Franz
freakkkkkk	freak
freeman	free man
frickin	fricking
FRIDAY	friday
freidn	friend
freiend	friend
freinds	friends
frim	from
fromt	from
froma	from a
frusterated	frustrated
FUCKN	fucking
fukin	fucking
FUCKS	fucks
FULL	full
furture	further
futre	future
futrre	future
futture	future
FYL	fyl
GAME	game
amges	games
gansgisterrr	gangster
gansta	gangster
gary	Gary
gas	Gary
gasy	Gary
gaz	Gary
geez	geezer
geezas	geezers
gerneral	general
geniussss	genius
genous	genius
gestire	gesture
getv	get
GETS	gets
geting	getting
gettihng	getting
gettii9ng	getting
gettin	getting
GF	girlfriend
gibve	give
gves	gives
givib	giving
GO	go
ggo	go
gi	go
goui	go
God	god
GOES	goes
goessss	goes
gose	goes
gowes	goes
gusess	goes
ging	going
goig	going
goin	going
goint	going
gonig	going
gooing	going
gorwn	going
gouin	going
GNNA	going to
gana	going to
gionna	going to
gnna	going to
gonn	going to
gta	going to
gto	going to
guna	going to
gunna	going to
GONE	gone
GOOD	good
goodd	good
gud	good
gooddoes	good does
GOT	got
gotta	got to
Pgrammar	grammar
gramar	grammar
GRAVITY	gravity
gr8	great
grt	great
gt	great
greiving	grieving
grins	grind
groudn	ground
grounds	ground
grrrrrrrrrrrrrrrrrrrrrrrr	grr
gauran	guarantee
gaurantee	guarantee
gurantescrap	guarantee
guranteed	guaranteed
GUESS	guess
guesin	guessing
guiness	Guiness
GUY	guy
b\/guy	guy
gut	guy
GUYS	guys
GUYZ	guys
guyz	guys
MUHAHAHAHAHA	ha
haha	ha
hahah	ha
hahaha	ha
hehe	ha
hh	ha
muahahahahahahahahahahahahahahaaqaa	ha
'd	had
hammerred	hammered
hannah	Hannah
haoppen	happen
hapopen	happen
hapens	happens
happesns	happens
happines	happiness
HAPPY	happy
HAppy	happy
HARD	hard
harshlol	harsh
HAS	has
hase	has
hass	has
hasnt	hasn't
've	have
HAVE	have
ahve	have
av	have
ave	have
hab	have
hace	have
hacve	have
hae	have
haeve	have
hagve	have
hava	have
havbe	have
havwe	have
hsve	have
hv	have
hve	have
haven	haven't
havent	haven't
havnt	haven't
hvnt	haven't
hacving	having
havin	having
havind	having
havinh	having
HE	he
He	he
hbe	he
he	he
hhe	he
jhe	he
hecan	he can
hemight	he might
he\/she	he or she
hed	head
headphon	headphones
HEAR	hear
hearr	hear
haerd	heard
HEART	heart
haeart	heart
heaviedr	heavier
hevier	heavier
heavest	heaviest
haevuiness	heaviness
helen	Helen
HELL	hell
helloooooooo	hello
helooooooooooo	hello
helop	help
helpuf	help
heplp	help
HER	her
herr	her
hr	her
iher	her
jerher	her
her\/his	her / his
ere	here
herer	here
jhere	here
bhes	he's
hes	he's
eyh	hey
heyyy	hey
HI	hi
hih	hi
hiii	hi
hiiii	hi
hiiiiiiii	hi
HIGH	high
hiking\/walking	hiking / walking
HIM	him
hiim	him
him\/her	him / her
him\/she	him / she
imself	himself
HIS	his
hies	his
hisd	his
hiw	his
hkis	his
hois	his
hs	his
ihinhis	his
shis	his
his\/her	his / her
hm	hmm
hmmm	hmm
HOLD	hold
HOLE	hole
HOME	home
hom	home
ooligan	hooligan
horible	horrible
horrfic	horrific
ghhot	hot
oht	hot
ho0w	how
hw	how
However	however
howver	however
HUMANELY	humanely
hunderds	hundreds
HUNGRY	hungry
HUSBAND	husband
hsband	husband
huband	husband
hubby	husband
husb	husband
husbadn	husband
husbamd	husband
husdand	husband
IO	I
idid	I did
ifeel	I feel
ifound	I found
inkow	I know
ifink	I think
ithinkg	I think
I.E	i.e
IF	if
If	if
iff	if
ifi	if
ifs	if
oif	if
ilhaams	Ilhaams
il	ill
im	I'm
imm	I'm
iom	I'm
immediatly	immediately
imoral	immoral
impecible	impeccable
implys	implies
imp	important
impirtant	important
imporant	important
importamt	important
impotra	important
improtant	important
impossbilee	impossible
impossibel	impossible
limpossibel	impossible
IN	in
In	in
ni	in
oin	in
incase	in case
infact	in fact
infron	in front
infront	in front
imo	in my opinion
imop	in my opinion
uinbalanced	inbalanced
aincident	incident
cionclude	include
india	India
indian	Indian
inexperinced	inexperienced
info	information
onformation	information
inosent	innocent
inputtin	inputting
instaead	instead
instaed	instead
instaid	instead
insted	instead
instict	instinct
instint	instinct
insturctions	instructions
inturn	intern
inteerpreted	interpreted
interpretin	interpreting
interupt	interrupt
uinto	into
intorduced	introduced
invaled	invalid
ipoid	Ipod
irish	Irish
ielevant	irrelevant
irrelevent	irrelevant
irrelevnatn	irrelevant
'S	is
's	is
IS	is
isd	is
iz	is
ois	is
uis	is
issince	is since
issabelle	Isabel
islamic	Islamic
isnrt	isn't
isnty	isn't
init	isn't it
innit	isn't it
izzit	isn't it
entthrowing	isn't throwing
IT	it
It	it
itd	it
itil	it
itt	it
ittttttt	it
itand	it and
ITS	its
ists	its
tis	its
ITSELF	itself
iv	I've
ive	I've
jackson	Jackson
JAMES	James
james	James
jenkins	Jenkins
jesus	Jesus
jew	Jew
JOBSON	jobson
john	John
jon	John
jonb	John
johnson	Johnson
joka	joker
joka1	joker
jokrs	jokers
jolie	Jolie
JP	jp
JUMP	jump
hjump	jump
jumo	jump
jumop	jump
jump1	jump
jumpp	jump
jumt	jumped
jumpin	jumping
JUMPS	jumps
jumpss	jumps
JUST	just
js	just
jsut	just
katy	Katy
KEEP	keep
kepp	keep
keepinn	keeping
khaled	Khaled
Kid	kid
kii	kid
kikid	kid
kiddin	kidding
KILL	kill
Kill	kill
killig	killing
killin	killing
kinda	kind of
kindve	kind of
kirstie	Kirstie
KNOW	know
knnow	know
knoe	know
knoow	know
knowl	know
knowok	know
knoww	know
knpw	know
knwew	know
wknow	know
knowingh	knowing
KNOWLEDGE	knowledge
knowleg	knowledge
knowladgable	knowledgeable
kwn	known
KNOWS	knows
kyle	Kyle
labor	labour
LADY	lady
LAND	land
landoing	landing
LANGUAGE	language
languge	language
largeor	larger
las	last
LATE	late
l8r	later
laughin	laughing
leartn	learn
LEAST	least
kleave	leave
leafve	leave
leavhas	leaves
lec	lecture
LEFT	left
gleft	left
LEGEND	legend
leged	legend
lesso	lesson
LET	let
letanother	let another
lemme	let me
LETS	lets
letys	lets
leyts	lets
tlets	lets
lyer	liar
LICENSE	license
licence	license
lisence	license
LIFE	life
lfie	life
liffe	life
lyf	life
lyfe	life
liek	like
lik	like
likke	like
lk	like
lyk	like
lkand	like and
likey	likely
liklely	likely
likly	likely
LIPPED	lipped
LISTENING	listening
listenign	listening
literatureeey	literally
lil	little
LIVES	lives
lifes	lives
lioads	loads
loadsa	loads of
lock3ed	locked
lojg	log
LOGICAL	logical
LOL	lol
klol	lol
liol	lol
lolan	lol
lolll	lol
lollll	lol
lolz	lol
lool	lol
loool	lol
looool	lol
ollol	lol
olol	lol
lolok	lol ok
london	London
londons	London
LOOK	look
liook	look
ookin	looking
los	lose
losel	lose
loooser	loser
looses	loses
loosin	losing
loosing	losing
losin	losing
lossin	losing
lossing	losing
ilot	lot
losts	lots
lotttttsss	lots
lve	love
luved	loved
LOVES	loves
lovin	loving
LSD	LSD
lyin	lying
amde	made
mae	made
mafii	mafia
mani	main
MAJORITY	majority
majortity	majority
mak	make
makse	make
mk	make
mke	make
makin	making
manking	making
MAN	man
Man	man
mann	man
mandeep	Mandeep
smany	many
marriedd	married
mary	Mary
m8	mate
mater	mate
tmathemat	maths
matt	Matt
MAXIE	Maxie
MAY	may
mauybe	maybe
mayb	maybe
maybee	maybe
maybs	maybe
ME	me
mee	me
meee	me
meen	mean
mena	mean
MEANS	means
ment	meant
MECHANIC	mechanic
medecine	medicine
miedicine	medicine
maen	men
meqn	men
MENTION	mention
msgs	messages
msnger	messenger
migth	might
mite	might
myt	might
nmight	might
michael	Mike
mike	Mike
milion	million
MILLIONS	millions
milions	millions
myn	mine
mynn	mine
MINS	mins
MINUTE	minute
MINUTES	minutes
MINUTS	minutes
mins	minutes
miscaridge	miscarriage
mispelled	misspelled
misktakes	mistakes
mis-understood	misunderstood
MO	mo
MO.	mo
mobil	mobile
mo	moment
Monday	Monday
montana	Montana
MORALLY	morally
morew	more
morgan	Morgan
MOST	most
mos	most
mostt	most
mot	most
mst	most
msut	most
MOUNTAIN	mountain
moutain	mountain
mounthians	mountains
mountians	mountains
MR	Mr
Mr.	Mr
mr	Mr
mr.	Mr
Mrs	Mrs
mrs	Mrs
mrs.	Mrs
ms	Ms
mssn	msn
muc	much
muchermm	much
muvch	much
mukulaaal	Muk
mukulaal	Muk
muderers	murderers
muslim	Muslim
MUS	must
MUST	must
mmust	must
MY	my
My	my
mi	my
miself	myself
myseldf	myself
myuself	myself
naggin	nagging
narrator\/commentator	narrator / commentator
natuer	nature
nesseciarly	necessarily
NEED	need
ned	need
nedneed	need
NEEDED	needed
netywork	network
neva	never
wnewspaper	newspaper
nxt	next
NHS	NHS
NICE	nice
Nice	nice
NICK	Nick
NICKKKKK	Nick
Niky	Nick
knick	Nick
ncick	Nick
ncik	Nick
nicj	Nick
nicjk	Nick
nicjl	Nick
nick	Nick
nickisawesome	Nick
niocck	Nick
nucnick	Nick
nite	night
nyt	night
niutes	nights
NO	no
No	no
nio	no
njo	no
no.	no
no0o0o	no
noo	no
nop	no
nope	no
nobel	noble
nolble	noble
novle	noble
no1	noone
oone	noone
noraml	normal
N'T	not
NOT	not
Not	not
hnot	not
mnot	not
n't	not
net	not
niot	not
nots	not
nt	not
wnot	not
notsave	not save
NOTES	notes
nething	nothing
noffin	nothing
nopthing	nothing
nothin	nothing
notting	nothing
nthng	nothing
nufin	nothing
NOW	now
NOw	now
mnow	now
w\/now	now
nowlol	now lol
nowdays	nowadays
O	o
OBAY	obey
obv	obviously
obveously	obviously
obviouly	obviously
obvoiusly	obviously
occue	occur
OF	of
fio	of
fo	of
odf	of
ofc	of
ofdd	of
offcourse	of course
OFF	off
Off	off
ioff	off
oficial	official
oh	oh
ooooh	oh
omg	oh my god
OK	ok
k	ok
okay	ok
uk	ok
ol	old
ommitted	omitted
ON	on
ion	on
on1	on
ONE	one
ione	one
onne	one
1thing	one thing
1s	ones
1z	ones
ONLY	only
onl	only
onlty	only
onlu	only
onluy	only
onyl	only
oplny	only
ont	onto
ooops	oops
opps	oops
whoops	oops
OPERATE	operate
opinon	opinion
oppertunity	opportunity
opportuinity	opportunity
oppotunity	opportunity
oppurtunity	opportunity
OPTION	option
optn	option
OR	or
oor	or
oders	orders
OTHER	other
eother	other
otehr	other
othere	other
OTHERWISE	otherwise
otherwhise	otherwise
OUT	out
oout	out
outand	out and
outdome	outcome
outocome	outcome
OUTNUMBERED	outnumbered
OUTWEIGHS	outweighs
outweight	outweighs
OVER	over
ova	over
ove	over
onwn	own
pwned	owned
pak	pack
payed	paid
PAPER	paper
papaer	paper
papr	paper
parachuites	parachutes
parashoot	parachutes
parashutes	parachutes
prachutes	parachutes
paretn	parent
parentss	parents
particulatr	particular
partigular	particular
paasengers	passengers
passin	passing
opath	path
patitnet	patient
emguins	penguins
pennicilin	penicillin
openis	penis
EPEOPLE	people
PEOPLE	people
peeps	people
peiople	people
pelople	people
peo	people
peolple	people
peopel	people
peoples	people
peple	people
poeople	people
poeple	people
pople	people
ppapel	people
peoplewho	people who
pepsi	Pepsi
perghaps	perhaps
erson	person
perzson	person
poerson	person
prerson	person
personalitys	personalities
ersonally	personally
persionally	personally
Phoebs	Phoebe
phoebe	Phoebe
picasso	Picasso
PICKED	picked
PILOT	pilot
piolet	pilot
piolot	pilot
pioltet	pilot
plot	pilot
poilet	pilot
poilot	pilot
pilotnothing	pilot nothing
pissin	pissing
pitt	pit
Pits	pits
PLANE	plane
planing	planning
PLAY	play
pl0x	please
pls	please
plx	please
plz	please
plently	plenty
POINT	point
opoint	point
poit	point
Poke	poke
pok	poke
POKED	poked
gpopulation	population
portsmouth	Portsmouth
portuguese	Portuguese
postion	position
prossibilities	possibilities
possibilitiesthat	possibilities that
posibilty	possibility
possibilty	possibility
possiblity	possibility
possibkly	possibly
pster	poster
POTENTIAL	potential
potental	potential
potentilly	potentially
pourd	poured
preffer	prefer
pretgnany	pregnancy
opregent	pregnant
pergnant	pregnant
preg	pregnant
preganant	pregnant
pregannant	pregnant
pregant	pregnant
preggers	pregnant
pregnat	pregnant
pregnent	pregnant
pregnet	pregnant
pregrant	pregnant
pregz	pregnant
prehg	pregnant
prg	pregnant
prgannt	pregnant
prgnant	pregnant
prgnat	pregnant
PREDJUDICE	prejudice
preamature	premature
preess	press
prionviples	principles
probabilituy	probability
probabilty	probability
prbably	probably
priobably	probably
proabaly	probably
prob	probably
probally	probably
probly	probably
proli	probably
pronbably	probably
proobably	probably
propbably	probably
Problem	problem
proboem	problem
proplem	problem
probrlems	problems
probs	problems
prodprof	professor
prof	professor
proffesor	professor
prosfessor	professor
profeccssors	professors
progar	program
programm	program
promissed	promised
propler	proper
properloser	proper loser
pros\/prowse	pros
proswse	pros
prowse	pros
prostitues	prostitutes
prous	proud
provieds	provides
PUSSY	pussy
PUT	put
oput	put
oputs	puts
puttin	putting
q-bort	q-bot
qbot	q-bot
QUES	question
QUESTION	question
ques	question
questionging	questioning
QUICK	quick
QUITE	quite
RACE	race
REACH	reach
readin	reading
READY	ready
readdy	ready
readuy	ready
REAL	real
realize	realise
realized	realised
realizes	realises
mreality	reality
raeally	really
reaaalluy	really
reall	really
realy	really
rily	really
REASON	reason
resonable	reasonable
rekon	reckon
recordes	recorded
regreat	regret
relaiable	reliable
reli	rely
remaing	remaining
remeber	remember
rememberwe	remember we
reminsds	reminds
reaseach	research
reasearch	research
reaserach	research
reseac	research
reseach	research
resear	research
researcg	research
researcgm	research
researchy	research
researdch	research
reserch	research
resuced	researched
reasearchist	researcher
reseacrher	researcher
researcjhher	researcher
rreasercher	researcher
RESPONSE	response
resonsibilty	responsibility
responsibiltiy	responsibility
responsibily	responsibility
responsinbilty	responsibility
reslut	result
RETARDS	retards
RIGHT	right
iright	right
righjt	right
rihht	right
rirte	right
rit	right
ritw	right
rt	right
rtghe	right
rth	right
rti	right
riskin	risking
Rive	Rivers
Riviera	Rivers
ricverira	Rivers
rifvers	Rivers
riveiera	Rivers
riveria	Rivers
rivers	Rivers
riviara	Rivers
riviera	Rivers
rivuera	Rivers
ROCK	rock
ROOM	room
ruigh	rough
runin	running
ryan	Ryan
sacrifise	sacrifice
scarifice	sacrifice
secrifice	sacrifice
safelt	safely
safly	safely
savely	safely
SAID	said
saidf	said
saidi	said
sakle	sale
SAME	same
sanke	sank
santa	Santa
SAVE	save
dsave	save
sav	save
svae	save
sve	save
saaved	saved
savedd	saved
saveda	saved a
SAVING	saving
asaving	saving
dsving	saving
savin	saving
savinfg	saving
savunng	saving
svaing	saving
savingmummy	saving mummy
saving\/not	saving not
asaw	saw
SAY	say
sayb	say
saythi	say
sy	say
nsaying	saying
sain	saying
saing	saying
sayin	saying
SAYS	says
sayss	says
sez	says
scareda	scared
scernaio	scenario
senerio	scenario
sene	scene
schwarzenegger	Schwarzenegger
SCIENCE	science
cscience	science
sci	science
scicene	science
sciend	science
sicienc	science
Scientist	scientist
sceientist	scientist
sceintist	scientist
scienctist	scientist
scienrtist	scientist
scientis	scientist
scientsist	scientist
scientsit	scientist
scintist	scientist
scientiswhio	scientist who
SCISSORS	scissors
2nd	second
sec	second
sechmm	second hmm
SEE	see
c	see
cu	see you
cya	see you
seeems	seems
sean	seen
selliggn	selling
senf	send
sence	sense
senstnce	sentence
sentance	sentence
senteces	sentences
serieously	seriously
swweriously	seriously
servic	service
setep	set
sexya	sexy
shush	sh
shalll	shall
sharif	Sharif
shazza	Shazza
SHE	she
shea	she
shw	she
wshe	she
sh\/he	she / he
sheha	she ha
sheloves	she loves
sheteeches	she teaches
SHEET	sheet
SHEETS	sheets
hshes	she's
shoppin	shopping
SHOULD	should
dshould	should
hould	should
sghud	should
shdu	should
sheould	should
shhould	should
shold	should
shoud	should
shuld	should
shuda	should have
shouldrs	shoulders
similiar	similar
simon	Simon
pimpsons	Simpsons
simpsons	Simpsons
simsp	Simpsons
singel	single
singleh	single
sastar	sister
SITUATION	situation
sistuation	situation
sitauion	situation
situationr	situation
situatu	situation
situatuion	situation
situiation	situation
situtation	situation
situtauiojkjvjd	situation
ski'ing	skiing
SLAP	slap
sleepyyyyyyyyyyy	sleepy
slowley	slowly
SMART	smart
snowboardin	snowboarding
SO	so
sooo	so
sooooo	so
sooooooo	so
somuch	so much
soread	so read
soshould	so should
sofy	soft
sfoftware	software
solvin	solving
SOM	some
psome	some
som	some
somer	some
sone	some
sopme	some
sum	some
someoesearch	some research
somewhow	somehow
SOMEONE	someone
soneone	someone
sum1	someone
sum1z	someones
SUMFN	something
smething	something
soething	something
somefing	something
somethin	something
sometihn	something
someting	something
somthing	something
somwtthing	something
sth	something
sumfin	something
sumfing	something
sumink	something
somewherei	somewhere
somwehere	somewhere
somwhere	somewhere
sumwhere	somewhere
SOON	soon
asorry	sorry
soz	sorry
sprry	sorry
srry	sorry
sry	sorry
SORTED	sorted
spain	Spain
spanish	Spanish
sppared	spared
spcl	special
specualte	speculate
speach	speech
speel	spell
slpelling	spelling
spentall	spent all
SPIDER	spider
SPIDERS	spiders
SPIDERWOMAN	spiderwoman
spred	spread
stac	stack
STAND	stand
standadr	standard
STAR	star
startb	start
stra	start
startd	started
starvin	starving
STAY	stay
gstay	stay
tay	stay
STAYS	stays
stys	stays
STEER	steer
stept	stepped
steve	Steve
steves	Steve's
STILL	still
stil	still
stll	still
sttill	still
stoppig	stopping
strabnd	stranded
strawsorrr	straw
strenghth	strength
streess	stress
stresed	stressed
stressin	stressing
stucj	stuck
studeis	studies
stuides	studies
stuf	stuff
stupi	stupid
substancesss	substances
sucess	success
succeessfull	successful
successfull	successful
sucessfull	successful
SUCK	suck
sudeen	sudden
sufferering	suffering
suggeting	suggesting
sukh	Sukh
sukhman	Sukh
sumera	Sumera
sunderland	Sunderland
spose	suppose
supose	suppose
suposed	supposed
SURE	sure
sre	sure
suere	sure
sugery	surgery
surrey	Surrey
ssurvival	survival
surbvival	survival
survbival	survival
survial	survival
surviavail	survival
suvival	survival
servive	survive
sruvive	survive
surrivive	survive
surrvive	survive
surrvuive	survive
surviv	survive
survuv	survive
suvive	survive
survinvg	surviving
survivers	survivors
Sussie	Susie
siusie	Susie
suesie	Susie
susan	Susie
susie	Susie
susiea	Susie
susize	Susie
susse	Susie
sussie	Susie
susue	Susie
suszie	Susie
suussie	Susie
suzi	Susie
suzie	Susie
SUSIES	Susie's
Susies	Susie's
susies	Susie's
sewear	swear
swearrr	swear
swerar	swear
swizerland	Switzerland
tacbaan	Tacbaan
tacke	tack
tahiti	Tahiti
taake	take
takin	taking
taling	taking
TASK	task
TEACH	teach
tch	teach
theach	teach
teacwhat	teach what
teet	teat
theat	teat
techinical	technical
techinically	technically
technoques	techniques
theb	teh
TELL	tell
tel	tell
telll	tell
telme	tell me
tellin	telling
10misn	ten minutes
tesxt	test
txt	text
textning	texting
thant	than
thnks	thanks
THAT	that
ethat	that
ht	that
htat	that
hthat	that
rthat	that
taht	that
thas	that
thatb	that
thatd	that
thaty	that
thqat	that
thqt	that
tht	that
tjat	that
tyhat	that
thathe	that the
thatcher	Thatcher
das	that's
thats	that's
THE	the
THHE	the
The	the
a\/the	the
ethe	the
hte	the
hthe	the
htja	the
kthe	the
nthe	the
outhe	the
rthe	the
sthe	the
t5he	the
te	the
tehe	the
tgha	the
tghe	the
th	the
tha	the
tjh	the
tthe	the
tyhe	the
wthe	the
thebeep	the beep
thpeople	the people
thier	their
theis	theirs
THEM	them
sthem	them
themn	them
themself	themselves
themselv	themselves
THEN	then
den	then
hthen	then
tehen	then
tehn	then
thenm	then
thn	then
theoris	theories
THERE	there
der	there
dere	there
nuithere	there
ter	there
tere	there
ther	there
thereee	there
thr	there
herefore	therefore
thez	there's
THEY	they
htey	they
tey	they
thay	they
thety	they
theyy	they
thwey	they
thy	they
theyd	they'd
theyll	they'll
theyre	they're
hin	thin
THING	thing
TIHING	thing
fing	thing
thinf	thing
thinh	thing
ting	thing
fins	things
thins	things
thinguy	thingy
THINK	think
THINKN	think
hink	think
kthink	think
theink	think
thiikn	think
thiknk	think
thiknks	think
think\/wel	think
thinkg	think
thinnk	think
thionk	think
tink	think
thinkshe	think she
finkin	thinking
finking	thinking
thinkin	thinking
thinkn	thinking
tyhiking	thinking
THINKS	thinks
finks	thinks
thinkss	thinks
3rd	third
THIS	this
dis	this
thi	this
thias	this
ths	this
thsi	this
HTHISMAN	this man
thorwn	thorn
thosej	those
thosw	those
THOUGH	though
thgh	though
tho	though
thou	though
thouhgh	though
thuogh	though
tyhouighth	though
thougif	though if
thaught	thought
thrts	thoughts
thousan	thousand
000s	thousands
thoudaands	thousands
threee	three
3\/4	three quarters
thrgh	through
throughn	through
thru	through
throew	throw
thrw	throw
trow	throw
trthrow	throw
thowing	throwing
throwin	throwing
throwng	throwing
throwning	throwing
throinghim	throwing him
throwingoff	throwing off
THROWN	thrown
throwm	thrown
thworown	thrown
trown	thrown
ty	tie
TIGHT	tight
ltime	time
timne	time
tiome	time
ty\/time	time
tymd	timed
tina	Tina
TIYA	Tiya
TO	to
To	to
oto	to
otoi	to
tp	to
tofix	to fix
togo	to go
to\/hot	to hot
2gether	together
2gever	together
TOLD	told
DTOM	Tom
TOM	Tom
tom	Tom
tom\/nick	Tom / Nick
2morow	tomorrow
2moz	tomorrow
tmrw	tomorrow
tommorow	tomorrow
tomorrow	tomorrow
TOO	too
tooo	too
topm	top
TOT	tot
tiotal	total
toor	tour
twel	towel
traumatsised	traumatised
trimestesr	trimester
ntrue	true
rtru	true
rtrue	true
tru	true
TRUE	true
truee	true
ttrue	true
rtying	trying
tryin	trying
ptryna	trying to
TUTU	tutu
Tv	TV
20min	twenty minutes
1\/2	two
TWO	two
2ppl	two people
TYPE	type
Type	type
typ	type
y\/type	type
ty0peing	typing
tyoing	typing
typin	typing
umm	um
ummm	um
uunborn	unborn
underestimatin	underestimating
understant	understand
Undertaker	undertaker
unfortunatly	unfortunately
uique	unique
uwantred	unwanted
UP	up
uo	up
uop	up
UPED	upped
US	us
usefull	useful
useles	useless
usless	useless
vaccinatrion	vaccination
vehicles\/transport	vehicles / transport
verdic	verdict
Very	very
verry	very
victoria	Victoria
vieweres	viewers
VOTE	vote
WAIT	wait
wair	wait
wairwait	wait
wales	Wales
walke	walked
wannab	wannabe
WANT	want
WNT	want
wnt	want
wantto	want to
wna	want to
wntin	wanting
wqasn	was
wassccary	was scary
rwater	water
WAY	way
WE	we
qwe	we
w3e	we
wea	we
weboth	we both
weaknesswess	weaknesses
wearin	wearing
weigth	weight
werid	weird
wierd	weird
wekk	well
wel	well
welll	well
wer	were
werent	weren't
wesley	Wesley
nwest	west
weve	we've
WHAT	what
hwhat	what
waht	what
wat	what
wha	what
whtttttttttt	what
wot	what
wott	what
wt	what
watnot	what not
wtf	what the fuck
watever	whatever
whateva	whatever
woteva	whatever
WOTS	what's
wasup	what's up
wazup	what's up
wen	when
wher	where
wereas	whereas
qhwhih	which
whihc	which
whisch	which
wwhich	which
WHO	who
whoo	who
whow	who
whol	whole
whiom	whom
whos	who's
whios	whose
WHY	why
Y	why
y	why
wiked	wicked
WIFE	wife
WIFT	wife
whife	wife
widfe	wife
wife\/baby	wife / baby
wigan	Wigan
'll	will
IWLL	will
WILL	will
wil	will
willwho	will who
willin	willing
WIN	win
whise	wise
WITH	with
iwith	with
wioth	with
wirt	with
wirth	with
witht	with
wityh	with
wiv	with
wth	with
wityout	without
waoman	woman
womean	woman
WOMEN	women
woprk	work
worja	work
wrkkkkkkkkkkkkkk	work
wroked	worked
workin	working
wrkin	working
worlk	world
woiuld	would
wold	would
woud	would
wouls	would
woulsd	would
wouold	would
wouul	would
wouyld	would
wpuld	would
wud	would
wuiould	would
wuld	would
woulda	would have
wuda	would have
wouldnt	wouldn't
wudnt	wouldn't
WRITE	write
rwrite	write
ryting	writing
WRITTEN	written
wriiten	written
writtrnen	written
exbox	Xbox
xbox	Xbox
YEARS	years
YA	yes
YEH	yes
Yes	yes
hyer	yes
hyp	yes
iyeah	yes
yea	yes
yeah	yes
yeas	yes
yeash	yes
yeeh	yes
yeh	yes
yer	yes
yh	yes
yhe	yes
yhhh	yes
yhsy	yes
yeseterday	yesterday
yetthis	yet this
joga	yoga
you	York
YOU	you
YU	you
You	you
iyou	you
oyou	you
tyou	you
u	you
u.	you
uyou	you
uyuo	you
ypou	you
ubetta	you better
ugo	you go
youthough	you though
ure	your
youre	you're
urs	yours
yrs	yours
urself	yourself
yourslef	yourself
wuld've would have
wudn't would not